NO ./assets/north.xpm
SO ./assets/south.xpm
WE ./assets/west.xpm
EA ./assets/east.xpm
F 220,100,0
C 225,30,0

111111
1000N1

111111
